{
    "maps": [

        {
            "order": 2,

            "boxes" :  [
                [2, 5],
                [3, 7],
                [4, 5],
                [4, 8],
                [7, 5],
                [7, 2]
            ],

            "map": [
                ["X", "X", "X", "X", "X", "X", "X", "X", "X", "X", "X", "X", "X", "X", "X", "X", "X", "X", "X", "X", "X", "X"],
                ["X", "X", "X", "X", "X", ".", ".", ".", "X", "X", "X", "X", "X", "X", "X", "X", "X", "X", "X", "X", "X", "X"],
                ["X", "X", "X", "X", "X", ".", ".", ".", "X", "X", "X", "X", "X", "X", "X", "X", "X", "X", "X", "X", "X", "X"],
                ["X", "X", "X", "X", "X", ".", ".", ".", "X", "X", "X", "X", "X", "X", "X", "X", "X", "X", "X", "X", "X", "X"],
                ["X", "X", "X", ".", ".", ".", ".", ".", ".", ".", "X", "X", "X", "X", "X", "X", "X", "X", "X", "X", "X", "X"],
                ["X", "X", "X", ".", "X", ".", "X", "X", "X", ".", "X", "X", "X", "X", "X", "X", "X", ".", ".", ".", "8", "X"],
                ["X", ".", ".", ".", "X", ".", "X", "X", "X", ".", "X", "X", "X", "X", ".", ".", ".", ".", ".", ".", "8", "X"],
                ["X", ".", ".", ".", ".", ".", ".", ".", ".", ".", ".", ".", ".", ".", ".", ".", ".", ".", ".", ".", "8", "X"],
                ["X", "X", "X", "X", "X", ".", "X", "X", "X", "X", ".", "X", ".", "X", "X", "X", "X", ".", ".", ".", "8", "X"],
                ["X", "X", "X", "X", "X", ".", ".", ".", ".", ".", ".", "X", "X", "X", "X", "X", "X", "X", "X", "X", "X", "X"],
                ["X", "X", "X", "X", "X", "X", "X", "X", "X", "X", "X", "X", "X", "X", "X", "X", "X", "X", "X", "X", "X", "X"]
            ]
        },

        {
            "order": 1,

            "boxes" :  [
                [7, 11]
            ],

            "map": [
                ["X", "X", "X", "X", "X", "X", "X", "X", "X", "X", "X", "X", "X", "X", "X", "X", "X", "X", "X", "X", "X", "X"],
                ["X", "X", "X", "X", "X", ".", ".", ".", "X", "X", "X", "X", "X", "X", "X", "X", "X", "X", "X", "X", "X", "X"],
                ["X", "X", "X", "X", "X", ".", ".", ".", "X", "X", "X", "X", "X", "X", "X", "X", "X", "X", "X", "X", "X", "X"],
                ["X", "X", "X", "X", "X", ".", ".", ".", "X", "X", "X", "X", "X", "X", "X", "X", "X", "X", "X", "X", "X", "X"],
                ["X", "X", "X", ".", ".", ".", ".", ".", ".", ".", "X", "X", "X", "X", "X", "X", "X", "X", "X", "X", "X", "X"],
                ["X", "X", "X", ".", "X", ".", "X", "X", "X", ".", "X", "X", "X", "X", "X", "X", "X", ".", ".", ".", "8", "X"],
                ["X", ".", ".", ".", "X", ".", "X", "X", "X", ".", "X", "X", "X", "X", ".", ".", ".", ".", ".", ".", "8", "X"],
                ["X", ".", ".", ".", ".", ".", ".", ".", ".", ".", ".", ".", ".", ".", ".", ".", ".", ".", ".", ".", "8", "X"],
                ["X", "X", "X", "X", "X", ".", "X", "X", "X", "X", ".", "X", ".", "X", "X", "X", "X", ".", ".", ".", "8", "X"],
                ["X", "X", "X", "X", "X", ".", ".", ".", ".", ".", ".", "X", "X", "X", "X", "X", "X", "X", "X", "X", "X", "X"],
                ["X", "X", "X", "X", "X", "X", "X", "X", "X", "X", "X", "X", "X", "X", "X", "X", "X", "X", "X", "X", "X", "X"]
            ]
        }

    ]

}
